1111111111111111111111111111111
1P000000000001000000000000000C1
1011111111111011111111111111101
101C000000000010000C1000000C101
1010111111111110111010111110101
1010100000000000101010100010101
1010101111111111101010101110101
1010101000000C00101010100000101
1010101011111111101010111111101
1010101010000000101010100000001
1010101010111111101010101111111
1010101010100C00001010100000001
1010101010101111111010111111101
1010101010100000001010000000101
1010101010111111101011111110101
10101010100000C0101010000010101
1010101011111111101010111010101
1010101000000000101010001010101
1010101111111110101011101010101
1010100000000010101000101010101
10101011111110101C1110101010101
10101C000000001000000101010E101
1011111111111111111111101010101
1000000000000000000000001010101
1111111111111111111111111111111