1111111111
10P0000001
1000000001
1000000001
100000E001
1111111111