1111111111111111111111
1000000000000000000001
10P0000000000000000001
1000011111111100000001
1000000000000100000001
1000000000000100000001
1000011100000111100001
1000010000000000100001
1000010000000000100001
10000100000C0000100001
10000100C0000000100001
1000010000000000100001
100001000000E000100001
1000011111111111100001
1000000000000000000001
1111111111111111111111