11111111111
10P00000001
1000C000001
1000000001
100000E001
1111111111