1111111111
10P0000001
1000C00001
1111111111
100000E001
1111111111